Albaan	Aurea's_star
Alderaan_(New_Galactic_Empire)	Nharl
Anelsana	G-138
Aquilae_(Aquilaean_system)	Redhurne_star
Aria_Prime	Aldorus
Aris	Mandalah_system's_star
Arthezia	Eye_of_the_Pirate
Assorhan	Giddea's_sun
Bengely_Four	Throffdon_star
Boothi_XII	Redhurne_star
Chryselia	Nharl
Cornwall	Eye_of_the_Pirate
Corrida	Herrik's_sun
Cynestra	Aldorus
Daxan_Beta	Herrik's_sun
Dhandu	Aurea's_star
Edis_VII	Redhurne_star
Egips	Keral's_star
Erinn	Eye_of_the_Pirate
Eshan	Ziost
Espinar	Herrik's_sun
Espirion	Rama
Etti_IV	Colla
Exigar	Keral's_star
Exo	Nharl
Farhava_Beta	Aldorus
Filata	Redhurne_star
Galtor_VI	Paucris_Major's_sun
Gamerong	Throffdon_star
Geldoll	G-138
Gelemeade	Eye_of_the_Pirate
Geric_IV	Sirpar's_sun
Giddea	Fomalhaut
Granicus	Ziost
Gwongdeen	Redhurne_star
Hapan_(planet)	Sirpar's_sun
Hasskyn	Colla
Helleguth	Nharl
Herrik	Eye_of_the_Pirate
Hyperion_(planet)	Mandalah_system's_star
Insk	Fomalhaut
Jaelen	Mandalah_system's_star
Jashwa	Aurea's_star
J'doytzin_III	Giddea's_sun
Jeosyn	Throffdon_star
Jereth_VI	Rama
Jocal_Four	Redhurne_star
Jondora	Keral's_star
Kajim	Mandalah_system's_star
Kanzi	Sirpar's_sun
Katiz_Xemir's_homeworld	Colla
Kinzor	Mandalah_system's_star
Kiss	Herrik's_sun
Klaptun_IV	G-138
Klonoid	Throffdon_star
Korrilan_IV	Paucris_Major's_sun
Kupoh	Ziost
KX-112	Fomalhaut
La'drach	Nharl
Lanteeb	Herrik's_sun
Lexus_Nine	Paucris_Major's_sun
Llewebum	Redhurne_star
Lokori	Mandalah_system's_star
Lolet	Rama
Maateen	Sirpar's_sun
Marriten	Nharl
Moldour	Eye_of_the_Pirate
Monfreen	Ziost
Monsolar	Nharl
Moorja	Mandalah_system's_star
Morellia	Keral's_star
Neelanon	Eye_of_the_Pirate
Neskar	Aldorus
Nilrebmah_XIII	Paucris_Major's_sun
Noult	Giddea's_sun
Nyriaan	Aldorus
Ocahont	Nharl
Ogana_Major	G-138
Omereth	Colla
Ophuchi	G-138
Ord_Mynock	Sirpar's_sun
Ordnandell	Aurea's_star
Orkana	Aldorus
Orra	Colla
Orto	Aurea's_star
Patagonia	Giddea's_sun
Paucris_Major	Throffdon_star
Pavilion	Redhurne_star
Pedorian	Giddea's_sun
Peekoine	Keral's_star
Pelicd	Giddea's_sun
Pendarr_III	Throffdon_star
Philaxia	Nharl
Planet_Dull	G-138
Polarca_VII	Sirpar's_sun
Pollillus	Aurea's_star
Promencius_Four	Eye_of_the_Pirate
Raddan	Giddea's_sun
Rajtiri	Herrik's_sun
Rango_Tan	Rama
Remduba_II	Eye_of_the_Pirate
Ristal	Fomalhaut
Rokirex	Throffdon_star
Romossobar	Nharl
Rumil	Redhurne_star
Rywin	Sirpar's_sun
Safe_Home	Mandalah_system's_star
Sanjin	Eye_of_the_Pirate
Sanod	Mandalah_system's_star
Sarrish	Sirpar's_sun
Sedratis	Redhurne_star
Seleann	Colla
Seluket	Nharl
Sennoa	Nharl
Shingra	Herrik's_sun
Sicemon	Redhurne_star
Silunes	Aurea's_star
Skeressa	Giddea's_sun
Solstice_V	Colla
Soum	Keral's_star
Stewjon	Rama
Suba	Ziost
Takobo	Herrik's_sun
Talman_III	Nharl
Tehar	Throffdon_star
Tei-Untis	Herrik's_sun
Teklos	Sirpar's_sun
Temesher	Sirpar's_sun
Tensor_IV	Aldorus
Teralov	Fomalhaut
The_Graveyard_of_the_Dragons	Sirpar's_sun
Tisheraan	Eye_of_the_Pirate
Tormin	Ziost
Touksingal	Herrik's_sun
Trebold_Raynor's_homeworld	Herrik's_sun
Triffis	Colla
Tyrias	Ziost
Umax	Colla
U-One	Aldorus
Uro	Sirpar's_sun
Useria	Paucris_Major's_sun
Ushruu	Aurea's_star
Utapau_(Kessil_system)	Herrik's_sun
Valahari	Rama
Vald	Colla
Varkana	Mandalah_system's_star
Velusia	G-138
Veron	Nharl
Verroth	Nharl
Vertseth	Aldorus
Vetine	Keral's_star
Vorlag	Herrik's_sun
Waliar	Throffdon_star
Whiforla_II	Aldorus
Yaloris	Nharl
Yoshiro	Aurea's_star
Yout	Nharl
Zarak-Nine	Paucris_Major's_sun
